*X***XXXXX
***X*XXXXX
**XX*XXXXX
XXXX**XXXX
XXXXX**XXX
*XXXXX***X
*X***XXX**
*X*X**X***
*X*XX*X*X*
********X*