*X*XXX****
*X**X**XX*
*XX**XXXX*
**XX**XX**
X***X**X*X
XXX**X***X
XXXX*XXX*X
XXXX*X***X
XXXX***X**
XXXXXXXX**